{
    "name": "SAMPLE_2",
    "raw" : "┌────────────┤  ├─────────────┐  ┌────────────┤  ├─────────────┐
│~~~~~~~~~~~~│  │~~~~~~~~~~~~~│  │~~~~~~~~~~~~│  │~~~~~~~~~~~~~│
│~~~~~~~~~~~~│  │~~~~~~~~~~~~~│  │~~~~~~~~~~~~│  │~~~~~~~~~~~~~│
│~~~~~~~~~~~~│  │~~~~~~~~~~~~~│  │~~~~~~~~~~~~│  │~~~~~~~~~~~~~│
┴────────────┘  └─────────────│  ┴────────────┘  └─────────────│
                                                                
┬────────────┐                │  ┬────────────┐                │
│╒╒╒╒╒╒╒╒╒╒╒╒┆                │  │╒╒╒╒╒╒╒╒╒╒╒╒┆                │
│╒╒╒╒╒╒╒╒╒╒╒╒┆                │  │╒╒╒╒╒╒╒╒╒╒╒╒┆                │
│╒╒╒╒╒╒╒╒╒╒╒╒┆                │  │╒╒╒╒╒╒╒╒╒╒╒╒┆                │
│╒╒╒╒╒╒╒╒╒╒╒╒┆                │  │╒╒╒╒╒╒╒╒╒╒╒╒┆                │
│╒╒╒╒╒╒╒╒╒╒╒╒┆                │  │╒╒╒╒╒╒╒╒╒╒╒╒┆                │
│╒╒╒╒╒╒╒╒╒╒╒╒┆                │  │╒╒╒╒╒╒╒╒╒╒╒╒┆                │
└────────────┤  ├─────────────┘  └────────────┤  ├─────────────┘",
    "init_pos": [5, 1],
    "exits":{
                "5,0" : ["SAMPLE_1", [5, 95]],
                "5,63" : ["SAMPLE_1", [5, 1]]
                },
    "items": {
        "Teleporter": [13, 47],
        "Shoe": [11, 47]
    }
}
