{
    "name": "Community",
    "raw": "░░░░░░░░░░░░░░░░░░░░░░░░░░░░░░░░░░░░░░░░░░░░░░░░░░░░░░░░░░░░░░░░░░░░░░░░░░░░░░░░░░░░░░░░░░░░░░░░░░░░░░░░░░░░░░░░░░░░░░░░░░░░░░░░░░░░░░░░░░░░░░░░░░░░░░░░░░░░░░░░░░░░                    ░░░░░░░░░░░░░░░░
░░░░░░░░░░░░░░░░░░░░░░░░░░░░░░░░░░░░░░░░░░░░░░░░░░░░░░░░░░░░░░░░░░░░░░░░░░░░░░░░░░░░░░░░░░░░░░░░░░░░░░░░░░░░░░░░░░░░░░░░░░░░░░░░░░░░░░░░░░░░░░░░░░░░░░░░░░░░░░░░░░░░                    ░░░░░░░░░░░░░░░░
░░░░░░░░░░░░░░░░░░░░░░░░░░░░░░░░░░░░░░░░░░░░░░░░░░░░░░░░░░░░░░░░░░░░░░░░░░░░░░░░░░░░░░░░░░░░░░░░░░░░░░░░░░░░░░░░░░░░░░░░░░░░░░░░░░░░░░░░░░░░░░░░░░░░░░░░░░░░░░░░░░░░                    ░░░░░░░░░░░░░░░░
░░░░░░░░░░░░░░░░░░░░░░░░░░░░░░░░░░░░░░░░░░░░░░░░░░░░░░░░░░░░░░░░░░░░░░░░░░░░░░░░░░░░░░░░░░░░▉▉▉▉▉▉▉▉▉▉░░░░░░░░░░░░░░░░░░░░░░░░░░░░░░░░░░░░░░░░░░░░░░░░░░░░░░░░░░░░░░                    ░░░░░░░░░░░░░░░░
░░░░░░░░░░░░░░░░░░░░░░░░░░░░░░░░░░░░░░░░░░░░░░░░░░░░░░░░░░░░░░░░░░░░░░░░░░░░░░░░░░░░░░░░▉▉▉▉▉▉▉▉▉▉▉▉▉▉▉▉▉▉░░░░░░░░░░░░░░░░░░░░░░░░░░░░░░░░░░░░░░░░░░░░░░░░░░░░░░░░░░                    ░░░░░░░░░░░░░░░░
░░░░░░░░░░░░░░░░░░░░░░░░░░░░░░░░░░░░░░░░░░░░░░░░░░░░░░░░░░░░░░░░░░░░░░░░░░░░░░░░░░░░░░▉▉▉▉▉▉▉▉▉▉▉▉▉▉▉▉▉▉▉▉▉▉░░░░░░░░░░░░░░░░░░░░░░░░░░░░░░░░░░░░░░░░░░░░░░░░░░░░░░░░                    ░░░░░░░░░░░░░░░░
░░░░░░░░░░░░░░░░░░░░░░░░░░░░░░░░░░░░░░░░░░░░░░░░░░░░░░░░░░▉▉▉▉▉▉▉▉▉▉▉▉▉▉▉▉▉▉▉▉▉▉▉▉▉▉▉▉▉▉▉▉▉▉▉▉▉▉▉▉▉▉▉▉▉▉▉▉▉▉▉▉▉▉▉▉▉▉▉▉▉▉▉▉▉▉▉▉▉▉▉▉▉▉░░░░░░░░░░░░░░░░░░░░░░░░░░░░░░░░                    ░░░░░░░░░░░░░░░░
░░░░░░░░░░░░░░░░░░░░░░░░░░░░░░░░░░░░░░░░░░░░░░░░░░░░░░░░░░▉▉▉▉▉▉▉▉▉▉▉▉▉▉▉▉▉▉▉▉▉▉▉▉▉▉▉▉▉▉▉▉▉▉▉▉▉▉▉▉▉▉▉▉▉▉▉▉▉▉▉▉▉▉▉▉▉▉▉▉▉▉▉▉▉▉▉▉▉▉▉▉▉▉░░░░░░░░░░░░░░░░░░░░░░░░░░░░░░░░                    ░░░░░░░░░░░░░░░░
░░░░░░░░░░░░░░░░░░░░░░░░░░░░░░░░░░░░░░░░░░░░░░░░░░░░░░░░░░▉▉▉▉▉▉▉▉▉▉▉▉▉▉▉▉▉▉▉▉**************************************************▉▉▉▉░░░░░░░░░░░░░░░░░░░░░░░░░░░░░░                    ░░░░░░░░░░░░░░░░░░
░░░░░░░░░░░░░░░░░░░░░░░░░░░░░░░░░░░░░░░░░░░░░░░░░░░░░░░░░░▉▉▉▉▉▉▉▉▉▉▉▉▉▉▉▉▉▉▉▉**************************************************▉▉▉▉░░░░░░░░░░░░░░░░░░░░░░░░░░░░░░                    ░░░░░░░░░░░░░░░░░░
░░░░░░░░░░▉▉▉▉▉▉▉▉▉▉▉▉▉▉▉▉▉▉▉▉▉▉▉▉▉▉▉▉▉▉▉▉▉▉▉▉▉▉▉▉▉▉▉▉▉▉▉▉▉▉▉▉▉▉▉▉▉▉▉▉▉▉▉▉▉▉▉▉**************************************************▉▉▉▉░░░░░░░░░░░░░░░░░░░░░░░░░░░░░░                    ░░░░░░░░░░░░░░░░░░
░░░░░░░░░░▉▉▉▉▉▉▉▉▉▉▉▉▉▉▉▉▉▉▉▉▉▉▉▉▉▉▉▉▉▉▉▉▉▉▉▉▉▉▉▉▉▉▉▉▉▉▉▉▉▉▉▉▉▉▉▉▉▉▉▉▉▉▉▉▉▉▉▉▉▉▉▉▉▉▉▉▉▉▉▉▉▉▉▉▉▉▉▉▉▉▉▉▉▉▉▉▉▉▉▉▉▉▉▉▉▉▉▉▉▉▉▉▉▉▉▉▉▉▉▉▉▉░░░░░░░░░░░░░░░░░░░░░░░░░░░░░░                    ░░░░░░░░░░░░░░░░░░
░░░░░░░░░░▉▉▉▉▉▉▉▉▉▉▉▉▉▉▉▉▉▉▉▉▉▉▉▉▉▉▉▉▉▉▉▉▉▉▉▉▉▉▉▉▉▉▉▉▉▉▉▉▉▉▉▉▉▉▉▉▉▉▉▉▉▉▉▉▉▉▉▉▉▉▉▉▉▉▉▉▉▉▉▉▉▉▉▉▉▉▉▉▉▉▉▉▉▉▉▉▉▉▉▉▉▉▉▉▉▉▉▉▉▉▉▉▉▉▉▉▉▉▉▉▉▉░░░░░░░░░░░░░░░░░░░░░░░░░░░░░░                    ░░░░░░░░░░░░░░░░░░
░░░░░░░░░░▉▉▉▉▉▉▉▉▉▉▉▉▉▉▉▉▉▉▉▉▉▉▉▉▉▉▉▉▉▉▉▉▉▉▉▉▉▉▉▉▉▉▉▉▉▉▉▉▉▉▉▉▉▉▉▉▉▉▉▉▉▉▉▉▉▉▉▉▉▉▉▉▉▉▉▉▉▉▉▉▉▉▉▉▉▉▉▉▉▉▉▉▉▉▉▉▉▉▉▉▉▉▉▉▉▉▉▉▉▉▉▉▉▉▉▉▉▉▉▉▉▉▉▉▉▉▉▉▉▉▉▉░░░░░░░░░░░░░░░░░░░░                    ░░░░░░░░░░░░░░░░░░
░░░░░░░░░░▉▉▉▉▉▉▉▉▉▉▓▓▓▓▓▓▓▓▓▓▓▓▓▓▓▓▓▓▓▓▓▓▓▓▓▓▓▓▓▓▓▓▓▓▓▓▓▓▓▓▓▓▓▓▓▓▓▓▓▓▓▓▓▓▉▉▉▉▉▉▉▉▉▉▉▉▉▉▉▉▉▉▉▉▉▉▉▉▉▉▓▓▓▓▓▓▓▓▓▓▓▓▓▓▓▓▓▓▓▓▓▓▓▓▓▓▓▓▓▓▉▉▉▉▉▉▉▉▉▉▉▉▉▉▉▉░░░░░░░░░░░░░░░░                    ░░░░░░░░░░░░░░░░░░
░░░░░░░░░░▉▉▉▉▉▉▉▉▉▉▓▓▓▓▓▓▓▓▓▓▓▓▓▓▓▓▓▓▓▓▓▓▓▓▓▓▓▓▓▓▓▓▓▓▓▓▓▓▓▓▓▓▓▓▓▓▓▓▓▓▓▓▓▓▉▉▉▉▉▉▉▉▉▉▉▉▉▉▉▉▉▉▉▉▉▉▉▉▉▉▓▓▓▓▓▓▓▓▓▓▓▓▓▓▓▓▓▓▓▓▓▓▓▓▓▓▓▓▓▓▉▉▉▉▉▉▉▉▉▉▉▉▉▉▉▉░░░░░░░░░░░░░░░░                    ░░░░░░░░░░░░░░░░░░
░░░░░░░░░░▉▉▉▉▉▉▉▉▉▉▓▓▓▓▓▓▓▓▓▓▓▓▓▓▓▓▓▓▓▓▓▓▓▓▓▓▓▓▓▓▓▓▓▓▓▓▓▓▓▓▓▓▓▓▓▓▓▓▓▓▓▓▓▓▉▉▉▉▉▉▉▉▉▉▉▉▉▉▉▉▉▉▉▉▉▉▉▉▉▉▓▓▓▓▓▓▓▓▓▓▓▓▓▓▓▓▓▓▓▓▓▓▓▓▓▓▓▓▓▓▉▉▉▉▉▉▉▉▉▉▉▉▉▉▉▉▉▉░░░░░░░░░░░░░░                    ░░░░░░░░░░░░░░░░░░
░░░░░░░░░░▉▉▉▉▉▉▉▉▉▉▓▓▓▓▓▓▓▓▓▓▓▓▓▓▓▓▓▓▓▓▓▓▓▓▓▓▓▓▓▓▓▓▓▓▓▓▓▓▓▓▓▓▓▓▓▓▓▓▓▓▓▓▓▓▉▉▉▉▉▉▉▉▉▉▉▉▉▉▉▉▉▉▉▉▉▉▉▉▉▉▓▓▓▓▓▓▓▓▓▓▓▓▓▓▓▓▓▓▓▓▓▓▓▓▓▓▓▓▓▓▉▉▉▉▉▉▉▉▉▉▉▉▉▉▉▉▉▉▉▉░░░░░░░░░░░░                    ░░░░░░░░░░░░░░░░░░
░░░░░░░░░░▉▉▉▉▉▉▉▉▉▉▓▓▓▓▓▓▓▓▓▓▓▓▓▓▓▓▓▓▓▓▓▓▓▓▓▓▓▓▓▓▓▓▓▓▓▓▓▓▓▓▓▓▓▓▓▓▓▓▓▓▓▓▓▓▉▉▉▉▉▉▉▉▉▉▉▉▉▉▉▉▉▉▉▉▉▉▉▉▉▉▓▓▓▓▓▓▓▓▓▓▓▓▓▓▓▓▓▓▓▓▓▓▓▓▓▓▓▓▓▓▉▉▉▉▉▉▉▉▉▉▉▉▉▉▉▉▉▉▉▉░░░░░░░░░░░░                    ░░░░░░░░░░░░░░░░░░
░░░░░░░░░░▉▉▉▉▉▉▉▉▉▉▓▓▓▓▓▓▓▓▓▓▓▓▓▓▓▓▓▓▓▓▓▓▓▓▓▓▓▓▓▓▓▓▓▓▓▓▓▓▓▓▓▓▓▓▓▓▓▓▓▓▓▓▓▓▉▉▉▉▉▉▉▉▉▉▉▉▉▉▉▉▉▉▉▉▉▉▉▉▉▉▓▓▓▓▓▓▓▓▓▓▓▓▓▓▓▓▓▓▓▓▓▓▓▓▓▓▓▓▓▓▉▉▉▉▉▉▉▉▉▉▉▉▉▉▉▉▉▉▉▉▉▉░░░░░░░░░░                    ░░░░░░░░░░░░░░░░░░
░░░░░░░░░░▉▉▉▉▉▉▉▉▉▉▓▓▓▓▓▓▓▓▓▓▓▓▓▓▓▓▓▓▓▓▓▓▓▓▓▓▓▓▓▓▓▓▓▓▓▓▓▓▓▓▓▓▓▓▓▓▓▓▓▓▓▓▓▓▉▉▉▉▉▉▉▉▉▉▉▉▉▉▉▉▉▉▉▉▉▉▉▉▉▉▓▓▓▓▓▓▓▓▓▓▓▓▓▓▓▓▓▓▓▓▓▓▓▓▓▓▓▓▓▓▉▉▉▉▉▉▉▉▉▉▉▉▉▉▉▉▉▉▉▉▉▉░░░░░░░░░░                    ░░░░░░░░░░░░░░░░░░
░░░░░░░░░░▉▉▉▉▉▉▉▉▉▉▓▓▓▓▓▓▓▓▓▓▓▓▓▓▓▓▓▓▓▓▓▓▓▓▓▓▓▓▓▓▓▓▓▓▓▓▓▓▓▓▓▓▓▓▓▓▓▓▓▓▓▓▓▓▉▉▉▉▉▉▉▉▉▉▉▉▉▉▉▉▉▉▉▉▉▉▉▉▉▉▓▓▓▓▓▓▓▓▓▓▓▓▓▓▓▓▓▓▓▓▓▓▓▓▓▓▓▓▓▓▉▉▉▉▉▉▉▉▉▉▉▉▉▉▉▉▉▉▉▉▉▉░░░░░░░░░░                    ░░░░░░░░░░░░░░░░░░
░░░░░░░░░░▉▉▉▉▉▉▉▉▉▉▓▓▓▓▓▓▓▓▓▓▓▓▓▓▓▓▓▓▓▓▓▓▓▓▓▓▓▓▓▓▓▓▓▓▓▓▓▓▓▓▓▓▓▓▓▓▓▓▓▓▓▓▓▓▉▉▉▉▉▉▉▉▉▉▉▉▉▉▉▉▉▉▉▉▉▉▉▉▉▉▓▓▓▓▓▓▓▓▓▓▓▓▓▓▓▓▓▓▓▓▓▓▓▓▓▓▓▓▓▓▉▉▉▉▉▉▉▉▉▉▉▉▉▉▉▉▉▉▉▉▉▉░░░░░░░░                    ░░░░░░░░░░░░░░░░░░░░
░░░░░░░░░░▉▉▉▉▉▉▉▉▉▉▓▓▓▓▓▓▓▓▓▓▓▓▓▓▓▓▓▓▓▓▓▓▓▓▓▓▓▓▓▓▓▓▓▓▓▓▓▓▓▓▓▓▓▓▓▓▓▓▓▓▓▓▓▓▉▉▉▉▉▉▉▉▉▉▉▉▉▉▉▉▉▉▉▉▉▉▉▉▉▉▓▓▓▓▓▓▓▓▓▓▓▓▓▓▓▓▓▓▓▓▓▓▓▓▓▓▓▓▓▓▉▉▉▉▉▉▉▉▉▉▉▉▉▉▉▉▉▉▉▉▉▉░░░░░░░░                    ░░░░░░░░░░░░░░░░░░░░
░░░░░░░░░░▉▉▉▉▉▉▉▉▉▉▓▓▓▓▓▓▓▓▓▓▓▓▓▓▓▓▓▓▓▓▓▓▓▓▓▓▓▓▓▓▓▓▓▓▓▓▓▓▓▓▓▓▓▓▓▓▓▓▓▓▓▓▓▓▉▉▉▉▉▉▉▉▉▉▉▉▉▉▉▉▉▉▉▉▉▉▉▉▉▉▓▓▓▓▓▓▓▓▓▓▓▓▓▓▓▓▓▓▓▓▓▓▓▓▓▓▓▓▓▓▉▉▉▉▉▉▉▉▉▉▉▉▉▉▉▉▉▉▉▉▉▉░░░░░░░░                    ░░░░░░░░░░░░░░░░░░░░
░░░░░░░░░░▉▉▉▉▉▉▉▉▉▉▓▓▓▓▓▓▓▓▓▓▓▓▓▓▓▓▓▓▓▓▓▓▓▓▓▓▓▓▓▓▓▓▓▓▓▓▓▓▓▓▓▓▓▓▓▓▓▓▓▓▓▓▓▓▉▉▉▉▉▉▉▉▉▉▉▉▉▉▉▉▉▉▉▉▉▉▉▉▉▉▓▓▓▓▓▓▓▓▓▓▓▓▓▓▓▓▓▓▓▓▓▓▓▓▓▓▓▓▓▓▉▉▉▉▉▉▉▉▉▉▉▉▉▉▉▉▉▉▉▉▉▉░░░░░░░░                    ░░░░░░░░░░░░░░░░░░░░
░░░░░░░░░░▉▉▉▉▉▉▉▉▉▉▓▓▓▓▓▓▓▓▓▓▓▓▓▓▓▓▓▓▓▓▓▓▓▓▓▓▓▓▓▓▓▓▓▓▓▓▓▓▓▓▓▓▓▓▓▓▓▓▓▓▓▓▓▓▉▉▉▉▉▉▉▉▉▉▉▉▉▉▉▉▉▉▉▉▉▉▉▉▉▉▓▓▓▓▓▓▓▓▓▓▓▓▓▓▓▓▓▓▓▓▓▓▓▓▓▓▓▓▓▓▉▉▉▉▉▉▉▉▉▉▉▉▉▉▉▉▉▉▉▉▉▉░░░░░░░░                    ░░░░░░░░░░░░░░░░░░░░
░░░░░░░░░░▉▉▉▉▉▉▉▉▉▉▓▓▓▓▓▓▓▓▓▓▓▓▓▓▓▓▓▓▓▓▓▓▓▓▓▓▓▓▓▓▓▓▓▓▓▓▓▓▓▓▓▓▓▓▓▓▓▓▓▓▓▓▓▓▉▉▉▉▉▉▉▉▉▉▉▉▉▉▉▉▉▉▉▉▉▉▉▉▉▉▓▓▓▓▓▓▓▓▓▓▓▓▓▓▓▓▓▓▓▓▓▓▓▓▓▓▓▓▓▓▉▉▉▉▉▉▉▉▉▉▉▉▉▉▉▉▉▉▉▉░░░░░░░░░░                    ░░░░░░░░░░░░░░░░░░░░
░░░░░░░░░░▉▉▉▉▉▉▉▉▉▉▓▓▓▓▓▓▓▓▓▓▓▓▓▓▓▓▓▓▓▓▓▓▓▓▓▓▓▓▓▓▓▓▓▓▓▓▓▓▓▓▓▓▓▓▓▓▓▓▓▓▓▓▓▓▉▉▉▉▉▉▉▉▉▉▉▉▉▉▉▉▉▉▉▉▉▉▉▉▉▉▓▓▓▓▓▓▓▓▓▓▓▓▓▓▓▓▓▓▓▓▓▓▓▓▓▓▓▓▓▓▉▉▉▉▉▉▉▉▉▉▉▉▉▉▉▉▉▉▉▉░░░░░░░░░░                    ░░░░░░░░░░░░░░░░░░░░
░░░░░░░░░░▉▉▉▉▉▉▉▉▉▉▓▓▓▓▓▓▓▓▓▓▓▓▓▓▓▓▓▓▓▓▓▓▓▓▓▓▓▓▓▓▓▓▓▓▓▓▓▓▓▓▓▓▓▓▓▓▓▓▓▓▓▓▓▓▉▉▉▉▉▉▉▉▉▉▉▉▉▉▉▉▉▉▉▉▉▉▉▉▉▉▓▓▓▓▓▓▓▓▓▓▓▓▓▓▓▓▓▓▓▓▓▓▓▓▓▓▓▓▓▓▉▉▉▉▉▉▉▉▉▉▉▉▉▉▉▉▉▉░░░░░░░░░░░░                    ░░░░░░░░░░░░░░░░░░░░
░░░░░░░░░░▉▉▉▉▉▉▉▉▉▉▉▉▉▉▉▉▉▉▉▉▉▉▉▉▉▉▉▉▉▉▉▉▉▉▉▉▉▉▉▉▉▉▉▉▉▉▉▉▉▉▉▉▉▉▉▉▉▉▉▉▉▉▉▉▉▉▉▉▉▉▉▉▉▉▉▉▉▉▉▉▉▉▉▉▉▉▉▉▉▉▉▉▉▉▉▉▉▉▉▉▉▉▉▉▉▉▉▉▉▉▉▉▉▉▉▉▉▉▉▉▉▉▉▉▉▉▉▉▉▉▉▉▉▉▉▉░░░░░░░░░░░░░░                    ░░░░░░░░░░░░░░░░░░░░
░░░░░░░░░░▉▉▉▉▉▉▉▉▉▉▉▉▉▉▉▉▉▉▉▉▉▉▉▉▉▉▉▉▉▉▉▉▉▉▉▉▉▉▉▉▉▉▉▉▉▉▉▉▉▉▉▉▉▉▉▉▉▉▉▉▉▉▉▉▉▉▉▉▉▉▉▉▉▉▉▉▉▉▉▉▉▉▉▉▉▉▉▉▉▉▉▉▉▉▉▉▉▉▉▉▉▉▉▉▉▉▉▉▉▉▉▉▉▉▉▉▉▉▉▉▉▉▉▉▉▉▉▉▉▉▉▉▉▉▉▉░░░░░░░░░░░░                    ░░░░░░░░░░░░░░░░░░░░░░
░░░░░░░░░░▉▉▉▉▉▉▉▉▉▉▉▉▉▉▉▉▉▉▉▉▉▉                        ▉▉▉▉▉▉▉▉▉▉▉▉▉▉▉▉▉▉▉▉▉▉▉▉▉▉▉▉▉▉▉▉▉▉▉▉▉▉▉▉▉▉▉▉▉▉▉▉▉▉▉▉▉▉▉▉▉▉▉▉▉▉▉▉▉▉▉▉▉▉▉▉▉▉▉▉▉▉▉▉▉▉▉▉▉▉░░░░░░░░░░░░░░░░                    ░░░░░░░░░░░░░░░░░░░░░░
░░░░░░░░░░▉▉▉▉▉▉▉▉▉▉▉▉▉▉▉▉▉▉▉▉▉▉                        ▉▉▉▉▉▉▉▉▉▉▉▉▉▉▉▉▉▉▉▉▉▉**************************************************▉▉░░░░░░░░░░░░░░░░░░░░░░░░░░░░                    ░░░░░░░░░░░░░░░░░░░░░░
░░░░░░░░░░▉▉▉▉▉▉▉▉▉▉▉▉▉▉▉▉▉▉▉▉▉▉                        ▉▉▉▉▉▉▉▉▉▉▉▉▉▉▉▉▉▉▉▉▉▉**************************************************▉▉░░░░░░░░░░░░░░░░░░░░░░░░░░░░                    ░░░░░░░░░░░░░░░░░░░░░░
░░░░░░░░░░▉▉▉▉▉▉▉▉▉▉▉▉▉▉▉▉▉▉▉▉▉▉                        ▉▉▉▉▉▉▉▉▉▉▉▉▉▉▉▉▉▉▉▉▉▉**************************************************▉▉░░░░░░░░░░░░░░░░░░░░░░░░░░░░                    ░░░░░░░░░░░░░░░░░░░░░░
░░░░░░░░░░▉▉▉▉▉▉▉▉▉▉▉▉▉▉▉▉▉▉▉▉▉▉                        ▉▉▉▉▉▉▉▉▉▉▉▉▉▉▉▉▉▉▉▉▉▉▉▉▉▉▉▉▉▉▉▉▉▉▉▉▉▉▉▉▉▉▉▉▉▉▉▉▉▉▉▉▉▉▉▉▉▉▉▉▉▉▉▉▉▉▉▉▉▉▉▉▉▉░░░░░░░░░░░░░░░░░░░░░░░░░░                    ░░░░░░░░░░░░░░░░░░░░░░░░
░░░░░░░░░░▉▉▉▉▉▉▉▉▉▉▉▉▉▉▉▉▉▉▉▉▉▉▉▉▉▉░░░░░░░░░░░░░░░░░░░░▉▉▉▉▉▉▉▉▉▉▉▉▉▉▉▉▉▉▉▉▉▉▉▉▉▉▉▉▉▉▉▉▉▉▉▉▉▉▉▉▉▉▉▉▉▉▉▉▉▉▉▉▉▉▉▉▉▉▉▉▉▉▉▉▉▉▉▉▉▉▉▉▉▉░░░░░░░░░░░░░░░░░░░░░░░░░░                    ░░░░░░░░░░░░░░░░░░░░░░░░
░░░░░░░░░░▉▉▉▉▉▉▉▉▉▉▉▉▉▉▉▉▉▉▉▉▉▉▉▉▉▉░░░░░░░░░░░░░░░░░░░░░░░░░░░░░░░░░░░░░░░░░░░░░░▉▉▉▉▉▉▉▉▉▉▉▉▉▉▉▉▉▉▉▉▉▉▉▉▉▉░░░░░░░░░░░░░░░░░░▎▎░░░░░░░░░░░░░░░░░░░░░░░░░░░░                    ░░░░░░░░░░░░░░░░░░░░░░░░
░░░░░░░░░░▉▉▉▉▉▉▉▉▉▉▉▉▉▉▉▉▉▉▉▉▉▉▉▉▉▉░░░░░░░░░░░░░░░░░░░░░░░░░░░░░░░░░░░░░░░░░░░░░░░░▉▉▉▉▉▉▉▉▉▉▉▉▉▉▉▉▉▉▉▉▉▉░░░░░░░░░░░░░░░░░░░░▎▎░░░░░░░░░░░░░░░░░░░░░░░░░░░░                    ░░░░░░░░░░░░░░░░░░░░░░░░
░░░░░░░░░░▉▉▉▉▉▉▉▉▉▉▉▉▉▉▉▉▉▉▉▉▉▉▉▉▉▉░░░░░░░░░░░░░░░░░░░░░░░░░░░░░░░░░░░░░░░░░░░░░░░░░░░░▉▉▉▉▉▉▉▉▉▉▉▉▉▉░░░░░░░░░░░░░░░░░░░░░░░░▎▎░░░░░░░░░░░░░░░░░░░░░░░░░░                    ░░░░░░░░░░░░░░░░░░░░░░░░░░
░░░░░░░░░░▉▉▉▉▉▉▉▉▉▉▉▉▉▉▉▉▉▉▉▉▉▉░░░░░░░░░░░░░░░░░░░░░░░░░░░░░░░░░░░░░░░░░░░░░░░░░░░░░░░░░░░░░░░░░░░░░░░░░░░░░░░░░░░░░░░░░░░░░░▎▎░░░░░░░░░░░░░░░░░░░░░░░░░░                    ░░░░░░░░░░░░░░░░░░░░░░░░░░
░░░░░░░░░░▉▉▉▉▉▉▉▉▉▉▉▉▉▉▉▉▉▉▉▉▉▉▉▉▉▉▉▉▉▉▉▉░░░░░░░░░░░░░░░░░░░░░░░░░░░░░░░░░░░░░░░░░░░░░░░░░░░░░░░░░░░░░░░░░░░░░░░░░░░░░░░░░░░░▎▎░░░░░░░░░░░░░░░░░░░░░░░░░░                    ░░░░░░░░░░░░░░░░░░░░░░░░░░
░░░░░░░░░░▉▉▉▉▉▉▉▉▉▉▉▉▉▉▉▉▉▉▉▉▉▉▉▉▉▉▉▉▉▉▉▉░░░░░░░░░░░░░░░░░░░░░░░░░░░░░░░░░░░░░░░░░░░░░░░░░░░░░░░░░░░░░░░░░░░░░░░░░░░░░░░░▉▉▉▉▉▉▉▉▉▉░░░░░░░░░░░░░░░░░░░░░░                    ░░░░░░░░░░░░░░░░░░░░░░░░░░
░░░░░░░░░░▉▉▉▉▉▉▉▉▉▉▉▉▉▉▉▉▉▉▉▉▉▉▉▉▉▉▉▉▉▉▉▉░░░░░░░░░░░░░░░░░░░░░░░░░░░░░░░░░░░░░░░░░░░░░░░░░░░░░░░░░░░░░░░░░░░░░░░░░░░░░░░░▉▉▉▉▉▉▉▉▉▉░░░░░░░░░░░░░░░░░░░░░░                    ░░░░░░░░░░░░░░░░░░░░░░░░░░
░░░░░░░░░░▉▉▉▉▉▉▉▉▉▉▉▉▉▉▉▉▉▉▉▉▉▉▉▉▉▉▉▉▉▉▉▉░░░░░░░░░░░░░░░░░░░░░░░░░░░░░░░░░░░░░░░░░░░░░░░░░░░░░░░░░░░░░░░░░░░░░░░░░░░░░░░░▉▉▉▉▉▉▉▉▉▉░░░░░░░░░░░░░░░░░░░░                    ░░░░░░░░░░░░░░░░░░░░░░░░░░░░
░░░░░░░░░░▉▉▉▉▉▉▉▉▉▉▉▉▉▉▉▉▉▉▉▉▉▉░░░░░░░░░░░░░░░░░░░░░░░░░░░░░░░░░░░░░░░░░░░░░░░░░░░░░░░░░░░░░░░░░░░░░░░░░░░░░░░░░░░░░░░░░░▉▉▉▉▉▉▉▉▉▉░░░░░░░░░░░░░░░░░░░░                    ░░░░░░░░░░░░░░░░░░░░░░░░░░░░
░░░░░░░░░░▉▉▉▉▉▉▉▉▉▉▉▉▉▉▉▉▉▉▉▉▉▉░░░░░░░░░░░░░░░░░░░░░░░░░░░░░░░░░░░░░░░░░░░░░░░░░░░░░░░░░░░░░░░░░░░░░░░░░░░░░░░░░░░░░░░░░░▉▉▉▉▉▉▉▉▉▉░░░░░░░░░░░░░░░░░░░░                    ░░░░░░░░░░░░░░░░░░░░░░░░░░░░
░░░░░░░░░░▉▉▉▉▉▉▉▉▉▉▉▉▉▉▉▉▉▉▉▉▉▉▉▉▉▉░░░░░░░░░░░░░░░░░░░░░░░░░░░░░░░░░░░░░░░░░░░░░░░░░░░░░░░░░░░░░░░░░░░░░░░░░░░░░░░░░░░░░░░░░░░░░░░░░░░░░░░░░░░░░░░░░░░░                    ░░░░░░░░░░░░░░░░░░░░░░░░░░░░
░░░░░░░░░░▉▉▉▉▉▉▉▉▉▉▉▉▉▉▉▉▉▉▉▉▉▉▉▉▉▉░░░░░░░░░░░░░░░░░░░░░░░░░░░░░░░░░░░░░░░░░░░░░░░░░░░░░░░░░░░░░░░░░░░░░░░░░░░░░░░░░░░░░░░░░░░░░░░░░░░░░░░░░░░░░░░░░░░░                    ░░░░░░░░░░░░░░░░░░░░░░░░░░░░
░░░░░░░░░░▉▉▉▉▉▉▉▉▉▉▉▉▉▉▉▉▉▉▉▉▉▉▉▉▉▉░░░░░░░░░░░░░░░░░░░░░░░░░░░░░░░░░░░░░░░░░░░░░░░░░░░░░░░░░░░░░░░░░░░░░░░░░░░░░░░░░░░░░░░░░░░░░░░░░░░░░░░░░░░░░░░░░░                    ░░░░░░░░░░░░░░░░░░░░░░░░░░░░░░
░░░░░░░░░░▉▉▉▉▉▉▉▉▉▉▉▉▉▉▉▉▉▉▉▉▉▉▉▉▉▉░░░░░░░░░░░░░░░░░░░░░░░░░░░░░░░░░░░░░░░░░░░░░░░░░░░░░░░░░░░░░░░░░░░░░░░░░░░░░░░░░░░░░░░░░░░░░░░░░░░░░░░░░░░░░░░░░░                    ░░░░░░░░░░░░░░░░░░░░░░░░░░░░░░
░░░░░░░░░░▉▉▉▉▉▉▉▉▉▉▉▉▉▉▉▉▉▉▉▉▉▉░░░░░░░░░░░░░░░░░░░░░░░░░░░░░░░░░░░░░░░░░░░░░░░░░░░░░░░░░░░░░░░░░░░░░░░░░░░░░░░░░░░░░░░░░░░░░░░░░░░░░░░░░░░░░░░░░░░░░░                    ░░░░░░░░░░░░░░░░░░░░░░░░░░░░░░
░░░░░░░░░░▉▉▉▉▉▉▉▉▉▉▉▉▉▉▉▉▉▉▉▉▉▉░░░░░░░░░░░░░░░░░░░░░░░░░░░░░░░░░░░░░░░░░░░░░░░░░░░░░░░░░░░░░░░░░░░░░░░░░░░░░░░░░░░░░░░░░░▉▉▉▉▉▉▉▉▉▉░░░░░░░░░░░░░░░░░░                    ░░░░░░░░░░░░░░░░░░░░░░░░░░░░░░
░░░░░░░░░░░░░░░░░░▎▎░░░░░░░░░░░░░░░░░░░░░░░░░░░░░░░░░░░░░░░░░░░░░░░░░░░░░░░░░░░░░░░░░░░░░░░░░░░░░░░░░░░░░░░░░░░░░░░░░░░░░░▉▉▉▉▉▉▉▉▉▉░░░░░░░░░░░░░░░░                    ░░░░░░░░░░░░░░░░░░░░░░░░░░░░░░░░
░░░░░░░░░░░░░░░░░░▎▎░░░░░░░░░░░░░░░░░░░░░░░░░░░░░░░░░░░░░░░░░░░░░░░░░░░░░░░░░░░░░░░░░░░░░░░░░░░░░░░░░░░░░░░░░░░░░░░░░░░░░░▉▉▉▉▉▉▉▉▉▉░░░░░░░░░░░░░░░░                    ░░░░░░░░░░░░░░░░░░░░░░░░░░░░░░░░
░░░░░░░░░░░░░░░░░░▎▎░░░░░░░░░░░░░░░░░░░░░░░░░░░░░░░░░░░░░░░░░░░░░░░░░░░░░░░░░░░░░░░░░░░░░░░░░░░░░░░░░░░░░░░░░░░░░░░░░░░░░░▉▉▉▉▉▉▉▉▉▉░░░░░░░░░░░░░░░░                    ░░░░░░░░░░░░░░░░░░░░░░░░░░░░░░░░
░░░░░░░░░░░░░░░░░░▎▎░░░░░░░░░░░░░░░░░░░░░░░░░░░░░░░░░░░░░░░░░░░░░░░░░░░░░░░░░░░░░░░░░░░░░░░░░░░░░░░░░░░░░░░░░░░░░░░░░░░░░░▉▉▉▉▉▉▉▉▉▉░░░░░░░░░░░░░░░░         ʘ          ░░░░░░░░░░░░░░░░░░░░░░░░░░░░░░░░
░░░░░░░░░░░░░░░░░░▎▎░░░░░░░░░░░░░░░░░░░░░░░░░░░░░░░░░░░░░░░░░░░░░░░░░░░░░░░░░░░░░░░░░░░░░░░░░░░░░░░░░░░░░░░░░░░░░░░░░░░░░░░░░░▎▎░░░░░░░░░░░░░░░░░░░░                    ░░░░░░░░░░░░░░░░░░░░░░░░░░░░░░░░
░░░░░░░░░░░░░░░░░░▎▎░░░░░░░░░░░░░░░░░░░░░░░░░░░░░░░░░░░░░░░░░░░░░░░░░░░░░░░░░░░░░░░░░░░░░░░░░░░░░░░░░░░░░░░░░░░░░░░░░░░░░░░░░░▎▎░░░░░░░░░░░░░░░░░░                    ░░░░░░░░░░░░░░░░░░░░░░░░░░░░░░░░░░
░░░░░░░░░░░░░░░░░░▎▎░░░░░░░░░░░░░░░░░░░░░░░░░░░░░░░░░░░░░░░░░░░░░░░░░░░░░░░░░░░░░░░░░░░░░░░░░░░░░░░░░░░░░░░░░░░░░░░░░░░░░░░░░░▎▎░░░░░░░░░░░░░░░░░░                    ░░░░░░░░░░░░░░░░░░░░░░░░░░░░░░░░░░
░░░░░░░░░░░░░░░░░░▎▎░░░░░░░░░░░░░░░░░░░░░░░░░░░░░░░░░░░░░░░░░░░░░░░░░░░░░░░░░░░░░░░░░░░░░░░░░░░░░░░░░░░░░░░░░░░░░░░░░░░░░░░░░░▎▎░░░░░░░░░░░░░░░░░░                    ░░░░░░░░░░░░░░░░░░░░░░░░░░░░░░░░░░",
    "init_pos": [60,158],
    "exits": {"57,157" : ["SC",[0,172]]
},
    "items": {}
}